12 18
##################
#*      -       *#
#H    -----     H#
#H    H   H     H#
#^^^^^H   H^^^^^#
#     H   H     #
# %   H   H   % #
#^^^^^H^^^H^^^^^#
#     H   H     #
# @   H   H     #
#^^^^^^^^^^^^^^^^#
##################